11001100001110011000111111110000111111100001111111000111110001111110000111111111
11001100001110011000111111110000111111100001111111000111110001111110000111111111
11001100001110000000111111110000000111100001111111000111110001111110000111110000
11001100001111111000111111110000000111100000000000000111110001111110000111111000
11001100001111111000111111110000110001100001111111000111110001111110000111111100
00000000000000000000000110000000111101100001111111000000000000000000000000001110
00000111111100000000110110110000111101100001111111000000000001111110000000001110
00000111111100000000110000110000111101100001111111000111110001111110001110000000
00000111111100000000111111110000111101100001111111000111110001111110001110001111
01110111000000111100000000000000001100000000001100000111110001111110001110001111
01110111011100111100000000000000001110000000001100000111110001111110001110001111
01110111011100111100011100111110000000000000000000000000000001111110000000000000
01110000000000111100011100111110000110000111110000000000000000000000000111111000
00000000000000111100011100111110000110000111110000111110001110000000000111111000
00000000000000000000000000000000000000000000000000000000001110000000000000000000
11100111110001111100011110011111100011111111000011111000111111000011111000001110
11100111110001111100011110011111100011111111000011111000111111000011111000001110
11100111110001111100011110011111100011111111000011111000111111000011111000001110
00000000000000000000000000000000000000000000000000000000000000000000000000000000
00000000000000000000000000000000000000000000000000000000000000000000000000000000
11100111110001111100011110011111100011111111000011111000111111000011111000001110
11100111110001111100011110011111100011111111000011111000111111000011111000001110
00000000000000000000000000000000000000000000000000000000000000000000000000000000
00000000000000000000000000000000000000000000000000000000000000000000000000000000
11111100011111111000110011110000111101100001111111000111110001111110000111100111
11100111110001111100011110011111110000000000000011111100111111000000000000001110
11100111110001111100011110000000000011111111000011111000111111000011111000001110
11100111110001111100011110011111100011111111000011111000000000000011111000001110
11100111110001111100011110011111100001111111000011111000111111000011111000001110
00000111111100000000111111110000111001100001111111001111110001111110001110001111
01110111000000111100000000000000001100000000001100000111110001111110001110001111
01110111011100111100000000000000001110000000001100000111110001111110001110001111
01110111011100111100011100111110000000000000000000000000000001111110000000000000
00000000000000111100011100111110000110000111110000000000000000000000000111111000
00000000000000111100011100111110000110000111110000111110001110000000000111111000
00000000000000000000000000000000000000000000000000000000001110000000000000000000
11100111110001111100011110011111100011111111000011111000111111000011111000001110
11100111110001111100011110011111100011111111000011111000111111000011111000001110
11111100001111111000000011110000111011100001110011000111110001111110000111100111
11111100001111111000111111110000000011100001110011000111110001111110000111100111
11111100001111111000111111110000111111100001110011000111110001111110000111100111
00000000000000000000000000000000000000000000000000000000000000000000000000000000
11100111110001111100011110011111100011111111000011111000111111000011111000001110
11100111110001111100011110011111100000000000000011111000111111000000000000001110
11100111110001111100011110000000000011111111000011111000111111000011111000001110
11100111110001111100011110011111100011111111000011111000000000000011111000001110
11100111110001111100011110011111100011111111000011111000111111000011111000001110
00000111111100000000111111110000111101100001111111000111110001111110001110001111
00000111111100000000111111110000111101100001111111000111110001111110001110001111
00000111111100000000111111110000111101100001111111000111110001111110001110001111
00000111111100000000111111110000111101100001111111000111110001111110001110001111
00000000000000000000000000000000000000000000001111000000000000000000000000000000
00000000000000000000000000000000000000000000001111000000000000000000000000000000
11111111111111111111111111111111111111110000000000000000000000000011111111111111
11111111111111111111111111111111111111110000000000000000000000000011111111111111
