14
54
80
11000110001100011000110001100011000110001100011000110001100011000110001100011000
11000110001100011000110001100011000110001100011000110001100011000110001100011000
11000110001100011000110001100011000110001100011000110001100011000110001100011000
11000110001100011000110001100011000110001100011000110001100011000110001100011000
11000110001100011000110001100011000110001100011000110001100011000110001100011000
00000000000000000000000000000000000000000000000000000000000000000000000000000000
00000000000000000000000000000000000000000000000000000000000000000000000000000000
00000000000000000000000000000000000000000000000000000000000000000000000000000000
11000110001100011000110001100011000110001100011000110001100011000110001100011000
11000110001100011000110001100011000110001100011000110001100011000110001100011000
11000110001100011000110001100011000110001100011000110001100011000110001100011000
11000110001100011000110001100011000110001100011000110001100011000110001100011000
11000110001100011000110001100011000110001100011000110001100011000110001100011000
00000000000000000000000000000000000000000000000000000000000000000000000000000000
00000000000000000000000000000000000000000000000000000000000000000000000000000000
00000000000000000000000000000000000000000000000000000000000000000000000000000000
11000110001100011000110001100011000110001100011000110001100011000110001100011000
11000110001100011000110001100011000110001100011000110001100011000110001100011000
11000110001100011000110001100011000110001100011000110001100011000110001100011000
11000110001100011000110001100011000110001100011000110001100011000110001100011000
11000110001100011000110001100011000110001100011000110001100011000110001100011000
00000000000000000000000000000000000000000000000000000000000000000000000000000000
00000000000000000000000000000000000000000000000000000000000000000000000000000000
00000000000000000000000000000000000000000000000000000000000000000000000000000000
11111111111111111111111111111100000000000000000000111111111111111111111111111111
11111111111111111111111111111100000000000000000000111111111111111111111111111111
11111111111111111111111111111100000000000000000000111111111111111111111111111111
11111111111111111111111111111100000000000000000000111111111111111111111111111111
11111111111111111111111111111100000000000000000000111111111111111111111111111111
11111111111111111111111111111100000000000000000000111111111111111111111111111111
00000000000000000000000000000000000000000000000000000000000000000000000000000000
00000000000000000000000000000000000000000000000000000000000000000000000000000000
00000000000000000000000000000000000000000000000000000000000000000000000000000000
11000110001100011000110001100011000110001100011000110001100011000110001100011000
11000110001100011000110001100011000110001100011000110001100011000110001100011000
11000110001100011000110001100011000110001100011000110001100011000110001100011000
11000110001100011000110001100011000110001100011000110001100011000110001100011000
11000110001100011000110001100011000110001100011000110001100011000110001100011000
00000000000000000000000000000000000000000000000000000000000000000000000000000000
00000000000000000000000000000000000000000000000000000000000000000000000000000000
00000000000000000000000000000000000000000000000000000000000000000000000000000000
11000110001100011000110001100011000110001100011000110001100011000110001100011000
11000110001100011000110001100011000110001100011000110001100011000110001100011000
11000110001100011000110001100011000110001100011000110001100011000110001100011000
11000110001100011000110001100011000110001100011000110001100011000110001100011000
11000110001100011000110001100011000110001100011000110001100011000110001100011000
00000000000000000000000000000000000000000000000000000000000000000000000000000000
00000000000000000000000000000000000000000000000000000000000000000000000000000000
00000000000000000000000000000000000000000000000000000000000000000000000000000000
11000110001100011000110001100011000110001100011000110001100011000110001100011000
11000110001100011000110001100011000110001100011000110001100011000110001100011000
11000110001100011000110001100011000110001100011000110001100011000110001100011000
11000110001100011000110001100011000110001100011000110001100011000110001100011000
11000110001100011000110001100011000110001100011000110001100011000110001100011000